#共享	
OK	确定
Cancel	取消
Or	 或
None	无
Enable	启用
Disable	停用
#UI	
Message	讯息
QuestEventType000	任务开始
QuestEventType001	放弃任务
QuestEventType002	任务完成
QuestEventType003	任务失败
QuestEventType004	任务更新
#后面有留空格键是要做排版	
Method0	获得
Method1	减少
HintTypeMoney	{0}{1} 钱
HintTypeExp	{0}{1} 经验
HintTypeInventory	{0} {1} 个
HintTypeStealTodayDontSteal	今日已无法再对此人下手
HintTypeStealInventoryNull	对方身上空无一物
HintTypeStealProbabilityZero	对方戒备森严
HintTypeStealTooFar	目标距离太远
HintTypeStealAnimal	无法对野兽下手
HintTypeLearnDrug	习得 {0} 药方
HintTypeLearnCook	习得 {0} 食谱
HintTypeLearnForge	习得 {0} 蓝图
HintTypePropertyUp	你的 {0} 提升了
HintTypePropertyDown	你的 {0} 降低了
HintTypeAreaFriendlyUp	你与 {0} 的友好度上升了
HintTypeAreaFriendlyDown	你与 {0} 的友好度下降了
HintTypeTeammateFriendly	队友友好度上升了
HintTypeLevelUp	{0} 升级了
HintTypeTeamFull	你的队伍已满
HintTypeTeammmateJoin	{0} 加入队伍
HintTypeTeammmateLeave	{0} 离开队伍
HintTypeNicknameUnlocked	获得称号 {0}
HintTypeAchievement	达成成就目标 {0}
HintTypeAchievementStart	发现隐藏成就 {0}
HintTypeMadnessUp	你更为狂放不羁了
HintTypeMadnessDown	你更为狷介拘谨了
HintTypeMoralUp	你更为正气凛然了
HintTypeMoralDown	你更为邪气逼人了
HintTypeYinAndYangUp	你更为阳刚了
HintTypeYinAndYangDown	你更为阴柔了
HintTypeFallAndHurt	你由高处摔落减少了{0}气血
HintTypeFallAndDie	你摔死了
HintTypeFoodBufferDisappeared	{0}的{1}效果消失了
InventoryDialogTitle	使用物品
InventoryDialogTitle2	装备秘籍
InventoryDialogText	确定要使用
InventoryDialogText2	要修练 {0} 吗？
Interactive02	交谈
Interactive03	拿取
Interactive04	挖掘
Interactive05	采摘
Interactive06	捕捉
Interactive07	<color=#ff2222>暗取</color>
Interactive08	<color=#ff2222>袭击</color>
Interactive09	调查
Interactive10	猎捕
Interactive11	<color=#ff2222>暗捕</color>
Interactive12	猎杀
TalkStealNotice	你鬼鬼祟祟的在干甚么？
TalkAmbushPlayer1	我忽然想揍你一顿。
TalkAmbushPlayer2	我想跟阁下讨教几招。
TalkAmbushPlayer3	哈哈，打一架神清气爽，百病全消！
TalkAmbushPlayer4	承让了。
TalkAmbushNpc1	打架嘛？谁怕谁！
TalkAmbushNpc2	请赐教！
TalkAmbushNpc3	大家都是文明人，何必动手动脚的？
TalkAmbushNpc4	请恕我拒绝。
TalkAmbushNpc5	算你厉害，咱们走着瞧。
TalkAmbushNpc6	阁下武艺高强，佩服佩服。
TalkAmbushNpc7	哼，别得意，我不过是一时大意。
TalkAmbushNpc8	想不到我一个失手，竟败在你的手中。
TalkAmbushNpc9	哼，尽使些鬼蜮技俩，论真实本领，你绝非我对手...。
TalkAmbushNpc10	我...我竟然败给无名之辈...绝无可能...。
NoBook	尚未选择秘籍
ActivateA	请选择{0}
InventoryLevel	稀有度
InventoryLevel0	一般
InventoryLevel1	稀有
InventoryLevel2	卓越
InventoryLevel3	超凡
InventoryLevel5	特殊
Hurt0	伤害减免
Hurt1	搏击伤害
Hurt2	剑法伤害
Hurt3	刀法伤害
Hurt4	枪棍伤害
Hurt5	暗器伤害
Hurt6	短兵伤害
Hurt7	其他伤害
Hurt8	双剑伤害
Hurt9	双刀伤害
Hurt10	刀剑伤害
Hurt11	弓箭伤害
Hurt	伤害
Weight	重量
Durability	耐久
Hardness	硬度
BaseEffect	特殊效果
AdditiveEffect	附加效果
InventoryTip	涂抹于武器之上
InventoryTip0	无法直接使用
InventoryTip2	只能战斗中使用
InventoryTip98	无法修炼此秘籍，因为有限定对象！
InventoryTip99	限定装备：
CharacterProperty50	气血
CharacterProperty51	气血上限
CharacterProperty52	内力
CharacterProperty53	内力上限
CharacterProperty54	精力
CharacterProperty55	精力上限
CharacterProperty58	体魄
CharacterProperty59	资质
CharacterProperty108	金钱
CharacterProperty109	狂狷
CharacterProperty110	道德
CharacterProperty111	江湖声望
CharacterProperty112	阴阳
CharacterProperty196	暴击
CharacterProperty197	卸劲
CharacterProperty198	连击
CharacterProperty199	反击
CharacterProperty200	虚招
CharacterProperty301	搏击
CharacterProperty302	剑法
CharacterProperty303	刀法
CharacterProperty304	枪棍
CharacterProperty305	暗器
CharacterProperty306	短兵
CharacterProperty307	医术
CharacterProperty308	毒术
CharacterProperty309	内功
CharacterProperty310	轻功
CharacterProperty321	药草学
CharacterProperty322	矿物学
CharacterProperty323	窃盗学
CharacterProperty324	商务学
CharacterProperty400	内伤
CharacterProperty401	外伤
CharacterProperty402	中毒
CharacterProperty403	封穴
CharacterProperty404	迷惑
CharacterProperty405	晕眩
CharacterProperty406	分筋
CharacterProperty407	错骨
CharacterProperty408	散功
CharacterProperty409	冰封
CharacterProperty410	醉意
#阴阳	
YinAndYang0	至阴
YinAndYang1	少阴
YinAndYang2	
YinAndYang3	少阳
YinAndYang4	至阳
#感悟	
TalentType0	动
TalentType1	静
TalentType2	刚
TalentType3	柔
TalentType4	巧
TalentType5	拙
#区域	
Area0	江湖散人
Area1	拱石村
Area2	漱玉矶
Area3	大研镇
Area4	鹰猎人聚落
Area5	擎天寨
Area6	一世富贵酒庄
Area7	丈人村
Area8	西川都司
Area9	青城派
Area10	赤丹宫
Area11	石家庄
Area12	太华门
Area13	豹王寨
Area14	白马居
Area15	藏花草棚
Area16	南诏段氏
Area17	箐寨
Area18	禾家马帮
Area19	叶家马帮
Area20	噶玛寺
Area21	野兽
Area22	俏梦阁
Area23	迷魂水寨
Area24	赋闲书院
Area25	天龙寺
Area26	珍馐会
Area27	狼蛮族
Area28	金石谷
Area29	蔘王山
Area30	百兽庄
Area31	猎物
Area32	家畜
Area101	铁匠铺
Area102	旅店
Area103	当铺
Area104	毛皮店
Area105	肉铺
Area106	杂货店
Area107	药铺
Area108	蔬菜铺
Area109	水果铺
Area110	鱼铺
Area111	樵夫联盟
Area112	布庄
Area113	食品店
Area114	酒楼
Area115	玉坊
ArrivalEndOfWorld	前方区域未开放 请回头
#传言	
HearsayNoneArea	江湖上
HearsayAreaUnit	的
#队伍	
RemoveTeammateTitle	剔除队友
RemoveTeammate	是否剔除队友｢{0}」
TeamFull	队伍已满
GetExp	{0} 获得 {1} 点经验
#交易	
StoreNoItemTransaction	你得选择物品，我们才能交易喔。
StorePlayerMoneyLacking	你钱不够喔。
StorePlayerTotalPriceLow	你提供的物品价值太低，我不愿跟你交换。
StoreNpcMoneyLacking	我身上没这么多钱...
StorePlayerNoFavarites	看来你身上没有我想要的东西。
StoreNpcFavoriteHaveMoney	我喜欢金钱，你可以用金钱补差价。
StoreNpcDontWant	这东西我不需要，请选别的吧。
#传闻	
RumorNothing1	嗯，一路走来风平浪静，沿途欣赏风景，倒也不坏！
RumorNothing2	嗯，一路走来风平浪静，沿途欣赏风景，倒也不坏！
RumorNothing3	嗯，一路走来风平浪静，沿途欣赏风景，倒也不坏！
RumorNothing4	嗯，一路走来风平浪静，沿途欣赏风景，倒也不坏！
RumorNothing5	嗯，一路走来风平浪静，沿途欣赏风景，倒也不坏！
#锻造	
HurtRang	{0}~{1}%
BluePrintType1	搏击兵器
BluePrintType2	剑
BluePrintType3	刀
BluePrintType4	枪棍
BluePrintType5	短兵
BluePrintType6	箭器
BluePrintType7	防具
EquipPartType0	身
EquipPartType1	格
EquipPartType2	柄
EquipPartType3	环
EquipPartType4	头
EquipPartType5	缨
EquipPartType6	杆
EquipPartType7	尾
EquipPartType8	衬
EquipPartType9	面
EquipPartType10	骨
EquipPartType11	弦
EquipPartType12	矢
EquipPartType13	弓
EquipPartType14	涂毒
EquipPartType15	投炉
BaseProperty	基本属性
ForgeProperty	特殊效果
InventoryType301	拳谱
InventoryType302	剑法
InventoryType303	刀法
InventoryType304	枪术
InventoryType305	暗器
InventoryType306	短兵
InventoryType307	内功
InventoryType308	轻功
InventoryType309	医书
InventoryType310	毒经
InventoryType318	其他
InventoryType701	矿石
InventoryType702	木材
InventoryType703	投炉
InventoryType704	皮革
InventoryType705	丝
InventoryType706	筋
InventoryType707	火药
InventoryType708	黑血蛛毒
InventoryType709	断魂蜈蚣毒
InventoryType710	蝮蛇剧毒
InventoryType711	烈蝎毒
EffectLevel1	轻度
EffectLevel2	中度
EffectLevel3	高度
AchievementMode0	单一游戏制
AchievementMode1	总体累计制
AchievementType0	一般
AchievementType1	战斗
AchievementType2	剧情
AchievementType3	武学
AchievementType4	能力
AchievementType5	声望
AchievementType6	收藏
#游戏难度	
GameDifficulty0	简单
GameDifficulty1	普通
GameDifficulty2	困难
GameDifficulty3	炼狱
DifficultyDetails	详细说明
DifficultyWarning0	目前选择的游戏难易度为<color=#ff2222>炼狱</color>等级，部分游戏内容会有些不同：
DifficultyWarning1	
DifficultyWarning2	<color=#FFE829>˙战斗数值调整</color>：己方单位的战力会<color=#ff2222>削弱</color>，而敌方单位的战力会<color=#ff2222>增强</color>。
DifficultyWarning3	<color=#FFE829>˙战斗机制新增</color>：<color=#22FF22>己方势力(绿色)</color>任何单位<color=#ff2222>死亡</color>会导致<color=#ff2222>战斗失败</color>。
DifficultyWarning4	<color=#FFE829>˙战斗规则变化</color>：部分战役的<color=#ff2222>胜利条件</color>可能会有所改变，如友军保卫战等。
DifficultyWarning5	<color=#FFE829>˙兽王册调整</color>：兽王初始参战回合数提升。
DifficultyWarning6	
DifficultyWarning7	点选下方<color=#ff2222>详细说明</color>按钮，或打开<color=#ff2222>帮助页面</color>，可以看到更多难易度相关的解说，
DifficultyWarning8	若想更换其他难易度的玩家，请<color=#ff2222>重做问卷</color>选择其他难易度来进行游玩，
DifficultyWarning9	祝您旅途愉快！
#按键提示对应	
KeyName_UpArrow	↑
KeyName_DownArrow	↓
KeyName_LeftArrow	←
KeyName_RightArrow	→
KeyName_Arrow	↑/↓/←/→
KeyName_NumberArrow	数字键盘方向
KeyName_Alpha0	0
KeyName_Alpha1	1
KeyName_Alpha2	2
KeyName_Alpha3	3
KeyName_Alpha4	4
KeyName_Alpha5	5
KeyName_Alpha6	6
KeyName_Alpha7	7
KeyName_Alpha8	8
KeyName_Alpha9	9
KeyName_BackQuote	~
KeyName_Minus	-
KeyName_Equals	=
KeyName_Backslash	\
KeyName_LeftBracket	[
KeyName_RightBracket	]
KeyName_Semicolon	;
KeyName_Quote	'
KeyName_Comma	,
KeyName_Period	.
KeyName_LBRB	< / >
KeyName_Slash	/
KeyName_Escape	ESC
KeyName_LeftControl	LeftCtrl
KeyName_RightControl	RightCtrl
KeyName_LeftAnalogPress	左模拟游戏杆
KeyName_RightAnalogPress	右模拟游戏杆
KeyName_JoystickButton0	A
KeyName_JoystickButton1	B
KeyName_JoystickButton2	X
KeyName_JoystickButton3	Y
KeyName_JoystickButton4	LB
KeyName_JoystickButton5	RB
KeyDesc_Up	上/移动
KeyDesc_Down	下/移动
KeyDesc_Left	左/移动
KeyDesc_Right	右/移动
KeyDesc_Arrow	方向移动
KeyDesc_Confrim	确认
KeyDesc_Cancel	取消
KeyDesc_NumberUp	上/切换区块
KeyDesc_NumberDown	下/切换区块
KeyDesc_NumberLeft	左/切换区块
KeyDesc_NumberRight	右/切换区块
KeyDesc_NumberArrow	区块切换
KeyDesc_LB	左/切换页签
KeyDesc_RB	右/切换页签
KeyDesc_LBRB	切换页签
KeyDesc_LT	放大/拉近
KeyDesc_RT	缩小/拉远
KeyDesc_DpadUp	上箭头键
KeyDesc_DpadDown	下箭头键
KeyDesc_DpadLeft	左箭头键
KeyDesc_DpadRight	右箭头键
KeyDesc_Main	信息页面
KeyDesc_Team	物品界面
KeyDesc_Skill	武学界面
KeyDesc_Talent	感悟界面
KeyDesc_Map	任务接口
KeyDesc_Alchemy	配方界面
KeyDesc_Achievement	成就界面
KeyDesc_System	系统选单
KeyDesc_SaveGame	自动存档
KeyDesc_X	踢除队友
KeyDesc_Y	整理背包
KeyDesc_ShowHerb	显示采集物
KeyDesc_MouseLeft	确定/选取
KeyDesc_MouseRight	取消
KeyDesc_MouseMiddle	调整远近/上下滚动
KeyDesc_LeftAnalogPress	左模拟游戏杆
KeyDesc_RightAnalogPress	重置摄影机
KeyDesc_AddSpeed	冲刺
KeyDesc_Jump	跳跃
KeyDesc_AutoRun	自动跑步
KeyDesc_Steal	暗取
KeyDesc_Ambush	切磋
KeyDesc_SkillShortcut1	技能快捷键1
KeyDesc_SkillShortcut2	技能快捷键2
KeyDesc_SkillShortcut3	技能快捷键3
KeyDesc_SkillShortcut4	技能快捷键4
KeyDesc_SkillShortcut5	技能快捷键5
KeyDesc_SkillShortcut6	技能快捷键6
KeyDesc_OpenInventory	开启战斗背包
KeyDesc_OpenLearnedSkill	开启战斗技能
KeyDesc_BattleRest	战斗休息
KeyDesc_BattleWaiting	战斗等待
KeyDesc_ScreenShot	撷取屏幕
KeyDesc_ShowCursor	显示鼠标
#游戏提示	
GameHint1	在主选单、ESC选单及角色属性接口右上角的问号钮，都可以找到游戏百科，方便查询游戏讯息。
GameHint2	在野外探索时，按V键可以帮助你快速寻找矿石或是药草。
GameHint3	战斗时，点击左上小头像可以开启角色战斗讯息接口，了解更多该角色的细部信息。
GameHint4	战斗时，点击左上小头像可以听到该角色的语音对话还可以开启角色战斗讯息接口，了解更多该角色的细部信息。
GameHint5	任务的难度分为简单(白色)、普通(橘色)、困难(红色)三级，尽量选择适合自己能力的任务来进行。
GameHint6	角色可以装备一把主武器和一把副武器，利用不同武器的特色来取得战斗的优势。
GameHint7	每个角色可装备的负重上限不同，若超过负重最大值会使角色行动力降低。
GameHint8	有些任务会有在地图上有位置的提示，方便玩家辨别。
GameHint9	您可以依照喜好或习惯，在设定中选择使用小地图或是方位条来进行定位辅助。
GameHint10	在主选单、ESC选单及角色属性接口右上角的问号钮，都可以找到游戏百科，方便您查询游戏讯息。
GameHint11	武器与装备的耐久度会影响攻击与防御的数值，可以找铁匠帮忙修理装备。
GameHint12	不需要的武器和防具，可以贩卖给商人换取银两，也能找铁匠拆解成少量的锻造素材。
GameHint13	学习医术能将野外采摘的药草提炼为丹药，强化恢复的效果。
GameHint14	马夫可以将玩家快速送达目的地，不过必须是您曾经去过的地方。
GameHint15	商人有营业项目的差异，您无法向商人交易他们不喜欢的物品类型。
GameHint16	若卡在异处无法脱身，不妨先按下两次ESC开关主选单，再看看结果。
GameHint17	反击并不会消耗精力，但会消耗更多内力。
GameHint18	战斗时如果内力不够，威力将会降低许多。
GameHint19	战斗时按Alt键可显示目标物与光标之间的距离，方便移动时决定走到的位置。
GameHint20	玩家角色性格的变化，会影响队友之间的互动，也可能改变队友一同冒险的意愿。
GameHint21	靠近NPC时长按F键，可以暗取其身上的物品，不过要小心被发现。
GameHint22	在野外探索时，请随时保持良好的战斗准备，并留意敌人的强度。
GameHint23	使用稀有度越高的材料进行锻造，可以打造出较好的武器与防具。
GameHint24	河洛世界中有许多事物等待玩家去探索，请多留意周遭可以互动的项目。
GameHint25	学习烹饪技术可以料理食材，做出美味的食物，食用后可以获得暂时性的增益效果。
GameHint26	您可以依照游戏习惯，在环境设定的操作分页中选择是否使用「视角自动跟随鼠标」的模式来进行游戏。
#任务	
QuestStep	任务步骤
QuestDescTitle	任务描述
#存读档	
Save	储存
Load	读取
Saving	储存中
Loading	读取中
LoadWhenModDifferent	存盘所使用模块 {0} 与当前模块 {1} 不同！
Deleting	正在通往主选单的道路上
NoFile	没有已储存的进度
SaveTypeFast	快速存档
SaveTypeAuto	自动存档
SaveTypeManual	存档{0}
TotalPlayTime	总游戏时间
DayFromBeginning	第{0}天
LoadFile	是否要读取{0}？
OverwriteFile	是否覆盖此存盘记录？
SaveGameMessage	已存档
LevelLabel	级
Delete	删除存档
DeleteFile	是否要删除此存盘记录？
LoadingCreatePlayer	少年横空
LoadingCreateScene	信步山河
LoadingCreateNpc	眺彼红尘
LoadingCreateEventCube	弹剑作歌
LoadingEndState	花径不曾缘客扫，蓬门今使为君开。
#UI系列	
InventoryType1	武器
InventoryType2	防具
InventoryType3	武学秘籍
InventoryType4	丹药
InventoryType5	毒物
InventoryType6	食物
InventoryType7	锻造材料
InventoryType8	杂物
InventoryType1001	丹药食物
InventoryType1002	采集物品
InventoryType1003	其它
InventoryType1004	装备
UIInventoryType101	拳套
UIInventoryType102	剑类
UIInventoryType103	刀类
UIInventoryType104	枪棍
UIInventoryType105	暗器弓箭
UIInventoryType106	短兵
UIInventoryType201	护甲
UIInventoryType202	饰品
UIInventoryType203	外衣
UIInventoryType301	丹药
UIInventoryType302	药材
UIInventoryType303	食物
UIInventoryType304	食材
UIInventoryType401	毒物
UIInventoryType402	锻造材料
UIInventoryType403	淬炼材料
UIInventoryType404	毛皮
UIInventoryType501	搏击
UIInventoryType502	剑法
UIInventoryType503	刀法
UIInventoryType504	棍法
UIInventoryType505	暗器弓箭
UIInventoryType506	短兵
UIInventoryType507	心法
UIInventoryType508	其它
UIInventoryType601	任务道具
UIInventoryType602	杂货
#说明分类	
HelpCatalogType1	游戏说明
HelpCatalogType101	操作方法
HelpCatalogType102	游戏时间
HelpCatalogType103	互动
HelpCatalogType104	便利功能
HelpCatalogType105	队友
HelpCatalogType106	交易
HelpCatalogType107	成就
HelpCatalogType108	配方
HelpCatalogType109	游戏难度
HelpCatalogType110	江湖传言
HelpCatalogType2	角色
HelpCatalogType201	一般属性
HelpCatalogType202	武学属性
HelpCatalogType203	负面属性
HelpCatalogType204	装备
HelpCatalogType205	称号
HelpCatalogType3	武学
HelpCatalogType301	武学说明
HelpCatalogType302	秘籍
HelpCatalogType303	技能类型
HelpCatalogType304	技能信息
HelpCatalogType4	感悟
HelpCatalogType401	感悟说明
HelpCatalogType402	感悟分类
HelpCatalogType5	任务地图
HelpCatalogType501	地图
HelpCatalogType502	任务
HelpCatalogType503	传送
HelpCatalogType504	定位辅助
HelpCatalogType6	战斗
HelpCatalogType601	战斗说明
HelpCatalogType602	特技值
HelpCatalogType603	减益状态
HelpCatalogType604	战斗辅助
HelpCatalogType7	锻造系统
HelpCatalogType701	锻造
HelpCatalogType702	淬炼
HelpCatalogType703	修理
HelpCatalogType704	拆解
HelpCatalogType705	重锻
HelpCatalogType8	道具
HelpCatalogType801	武器
HelpCatalogType802	防具
HelpCatalogType803	丹药与食物
HelpCatalogType804	毒物
HelpCatalogType805	锻造/淬炼材料
HelpCatalogType806	其它物品
#接口名称	
UICompass	方位条
UIMinimap	小地图
UITrackedQuest	任务追踪
#创角界面	
UICreateEnterText	在进入河洛群侠传这个世界之前，有些问题需要请您回答！<br>你准备好了吗？
UICreateClickToContinue	点击以继续
UICreateQuestNo	问题
UICreateInvestigateTitle	请无视现实，选择您内心深处最深切的期盼
UICreateNext	下一页
UICreateError1	尚有未作答的字段
UICreateRenameTitle	最后，请替您自己在这个武侠世界取一个响叮当的名字
UICreateNameText	姓名
UICreateIllegalName	姓名含有非法字符串！
UICreateAnalyzeTitle	分析中......
UICreateRename	重新取名
UICreateReinvestigate	重做问卷
UICreateRandomProperty	重骰数值
UICreateStartGame	开始游戏
UICreateMessage01	重做问卷会重新分析您的特质，给予您合适的结果，确定要放弃当前结果吗？
UICreateMessage02	是否要以<color=#3174F8>{0}</color>的身分进入河洛世界展开冒险吗？
UICreateMessage03	此名称已经被其他玩家使用过了！
#Main界面	
UIMainTabInventory	物品
UIMainTabSkill	武学
UIMainTabTalent	感悟
UIMainTabQuestMap	任务
UIMainTabAlchemy	配方
UIMainTabRest	休息
UIMainTabAchievement	成就
#队伍接口(物品接口)	
UITeamLevelLabel	等级
UITeamExpLabel	经验
UITeamNoNickname	无称号
UITeamWeightLabel	装备总重
UITeamEquipColumn0	主手武器
UITeamEquipColumn1	副手武器
UITeamEquipColumn2	护甲
UITeamEquipColumn3	饰品
UITeamEquipColumn4	外衣
UITeamPersonality1	人格
UITeamPersonality2	邪
UITeamPersonality3	正
UITeamPersonality4	狷
UITeamPersonality5	狂
UITeamPersonality6	阴
UITeamPersonality7	阳
UITeamSkillProperty	武学
UITeamTalentName	感悟
UITeamResidual	剩余 {0} 时
UITeamDuration	持续 {0} 时
#炼金接口(生产接口)	
UIAlchemyTabDrug	炼丹
UIAlchemyTabPoison	毒术
UIAlchemyTabCook	烹饪
UIAlchemyTabForge	锻造
UIAlchemyButtonDrug	炼丹开始
UIAlchemyButtonPoison	制毒开始
UIAlchemyButtonCook1	烹饪开始
UIAlchemyButtonCook2	请找烹饪大师制作
UIAlchemyButtonForge1	锻造开始
UIAlchemyButtonForge2	请找锻造大师制作
UIAlchemyEffectTitle1	食用效果
UIAlchemyEffectTitle2	使用效果
UIAlchemyEffectTitle3	伤害效果
UIAlchemyTip1	完成
UIAlchemyNotEnough	材料不足
UIAlchemyMaterialTitle	材料需求
UIAlchemyNoEffect	无效果
#方位条界面	
UICompassDirection1	东
UICompassDirection2	西
UICompassDirection3	南
UICompassDirection4	北
DirectionUnit	方
AreaNone	野外地区
AreaNear	附近
#休息界面	
UIRestTimeTitle	现在时间
UIRestRestTitle	休息时间
UIRestRestUnit	小时
UIRestDialogTitle	休息
UIRestDialog	要休息 {0} 小时到 {1} 吗？
UIRestDialogError	可提供休息的道具数量不足！
#地图接口(任务接口)	
UIQuestMapTab0	进行中主线
UIQuestMapTab1	进行中支线
UIQuestMapTab2	已完成任务
UIQuestMapTab3	失败的任务
UIQuestMapCellNew	新
#传送界面	
UITransferTitle	传送
UITransferMessage	是否传送至
#系统接口	
UISystemContinue	继续游戏
UISystemSave	储存游戏
UISystemLoad	读取游戏
UISystemEnvironment	环境设定
UISystemKeys	按键设定
UISystemEscape	卡点脱逃
UISystemAchievement	成就列表
UISystemReturn	回主选单
UISystemExit	离开游戏
UISystemHelp	游戏百科
UITitleNewGame	初入武林
UITitleLoad	再战江湖
UITitleMod	模块选择
UITitleModText	目前模块 : 河洛群侠传
UIModTitle	模块
#环境设定接口	
UISettingTitle	环境设定
SettingGroup0	视讯
SettingGroup1	音效
SettingGroup2	操作
SettingGroup3	游戏
SettingGroup4	3D Vision
UISettingWindow	画面设定
UISettingWindowState	画面模式
UISettingWindowState0	全屏幕
UISettingWindowState1	窗口化
UISettingWindowSize	分辨率
UIGraphicsSettingGeneral	一般设定
UIGraphicsSettingPlayerIK	主角贴合地板
UIGraphicsSettingCullingDistanceMultiplier	物件可见距离
UIGraphicsSettingShadowEnabled	阴影
UIGraphicsSettingShadowDistance	阴影距离
UIGraphicsSettingVSync	垂直同步
UIGraphicsSettingSkyDomeSetting	天空
UIGraphicsSettingVolumeLighting	光束
UIGraphicsSettingGlobalParticleEmissionRates	粒子密度
UIGraphicsSettingAmbientQuality	环境光质量
UIGraphicsSettingCloudsQuality	云层品质
UIGraphicsSettingResolution	体积光分辨率
UIGraphicsSettingPostProcessingSetting	画面效果
UIGraphicsSettingOcclusion	环境光遮蔽
UIGraphicsSettingBeautify	色差
UIGraphicsSettingLensDirt	镜头眩光
UIGraphicsSettingScreenSpaceShadow	阴影增强
UIGraphicsSettingBloom	高光
UIGraphicsSettingEyeAdaptation	光线适应
UIGraphicsSettingAntiAliasing	反锯齿
UIGraphicsSettingPostProcessVolume	动态模糊
UIGraphicsSettingPerspectiveCamera	深度摄影机
UIGraphicsSettingVegetationSetting	植被
UIGraphicsSettingPackage	品质
UIGraphicsSettingVisibleDistance	可见距离
UIGraphicsSettingFarVegetations	远方植被
UIGraphicsSettingDensity	密度
UIGraphicsSettingTreeDensity	树木密度
UIGraphicsSettingLevel	画面质量
UIGraphicsSettingLevelFastest	最快速
UIGraphicsSettingLevelFast	快速
UIGraphicsSettingLevelSimple	基本
UIGraphicsSettingLevelGood	好
UIGraphicsSettingLevelBeautiful	质量优先
UIGraphicsSettingLevelFantastic	全开
UIGraphicsSettingLevelCustom	自定义
UIGraphicsSettingVolumtericResolutionFull	高
UIGraphicsSettingVolumtericResolutionHalf	中
UIGraphicsSettingVolumtericResolutionQuarter	低
UIGraphicsSettingVegetationPackageHigh	高
UIGraphicsSettingVegetationPackageMid	中
UIGraphicsSettingVegetationPackageLow	低
UIGraphicsSettingBinaryQualityLow	低
UIGraphicsSettingBinaryQualityHigh	高
UIGraphicsSettingAntiAliasingNone	关闭
UIGraphicsSettingAntiAliasingLow	低
UIGraphicsSettingAntiAliasingHigh	高
UIGraphicsSettingSaveNotice	此设定必须重新启动游戏后才会生效
UISettingME	音效
UISettingBGM	背景音乐
UISettingAmbient	环境音乐
UISettingVoice	语音
UISettingVolume	音量
UISettingUI	界面
UISettingTalk	对话语音
UISettingFootStep	脚步音效
UISettingSwitch	开关
UISettingMapPlayerPosition	显示角色当前坐标
UISettingMapQuestIcon	显示任务位置标示
UISettingMsg1	是否要储存当前{0}设置？
UISettingMsg2	是否要舍弃当前{0}设置，回到预设的设定？
UICameraSetting	摄影机操作
UICameraSettingSpeed	视角移动速度
UICameraSettingHorizontal	移动视角水平相反
UICameraSettingVertical	移动视角垂直相反
UICameraSettingFollowCursor	视角自动跟随鼠标
UIDelayLoading	地图及人物延迟载入
#热键设定接口	
UIHotkeyTitle	按键设定
UIHotkeyDefault	回复预设
UIHotkeySave	套用
UIHotkeyInputMode1	键盘设置
UIHotkeyInputMode2	手把设置
UIHotkeyNormalGroup	移动键/操作键
UIHotkeyFunctionGroup	功能键
UIHotkeyUIGroup	界面快捷键
UIHotkeyBattleGroup	战斗快捷键
UIHotkeyHintText	请按下想要更换的按键
UIHotkeyHintSuccess	按键更换成功
UIHotkeyHintFailed0	不允许更换鼠标按键配置
UIHotkeyHintFailed1	按键已被定义特殊用途，请设定其他的键
UIHotkeyHintExchange	按键<color=#3174F8>{0}</color>已被设定为<color=#ff2222>{1}</color>，是否要互换按键设定？
UIHotkeyMsg1	是否要储存当前按键设置？
UIHotkeyMsg2	是否舍弃当前按键设置，回到默认的按键设置？
#交易接口	
UIStoreTransactionTitle	交易物品
UIStoreChangeTitle	交换物品
UIStoreMoneyHave	所持金额：
UIStoreTransaction	确认交易
UIStoreChange	确定交换
#技能界面(武学)	
UISkillBookExp	经验点数
UISkillRemovebook	卸下
UISkillBookExpert	精通
UISkillLearnSkill	修练武功
UISkillLearningBook	修炼
UISkillWorkingSkill	运行
UISkillPropertyTitle	属性
UISkillTreeNodeState1	修练中
UISkillTreeNodeState2	运行中
UISkillTreeNodeState3	反击中
UISkillNodeClickDialog	学习 {0} 将消耗 {1} 点技能经验值
UISkillConfirmButton	套用技能配置
UISkillUseNeigongButton	运行内功
UISkillLearnedSkill	已修练武功
UISkillCounterSkill	可装备的反击技
UISkillNeigongSkill	可运行的内功
UISkillInventoryFilterButton	筛选
UISkillInventoryFilter	秘籍显示分类
UISKillInventoryAllChoose	全选
UISkillExpDistributeTip1	获得的经验值会依照一定比例分配给秘籍，比例若调高，角色会获得较少的成长经验值，但可获得较多的秘籍经验点数。
UISkillExpDistributeTip2	(效果套用于全部队友)
UISkillTransfer	转换秘籍经验
UISkillTransferExp	是否要将{0}点秘籍经验转换为角色经验？
UISkillTransferNoExp	此秘籍没有经验点数可以转换
#天赋接口(感悟接口)	
UITalentConfirmButton	套用天赋配置
UITalentNodeClickDialog	精通 {0} 将消耗 {1} 点感悟点数
TalentTipNeedPoint	需求感悟点
TalentTipPCondition	需求属性
TalentTipTCondition	需求感悟
TalentTipBuffer	感悟特效
#追踪的任务接口	
UITrackedQuestTitle	当前没有追踪的任务
#称号界面	
UINicknameTitle1	称号
UINicknameTitle2	称号描述
UINicknameTitle3	装备效果
UINicknameNotEffect	没有效果
UINicknameConfirm	装备称号
UINicknameEquipping	装备中
#锻造界面	
UIBlacksmithTabForge	锻造
UIBlacksmithTabQuench	淬炼
UIBlacksmithTabRepair	修复
UIBlacksmithTabDecompose	拆解
UIBlacksmithTabReforge	重锻
UIBlacksmithTabSmelt	熔炼
UIBlacksmithFinalTitle	锻造成功
UIBlacksmithCosts	锻造费用：
UIBlacksmithDialog1	锻造所需费用为 {0} 文钱，您的金钱不足。
UIBlacksmithInventoryHint	装备中的物品必须先卸下至背包才会显示。
#淬炼界面	
UIQuenchError	此道具没有可淬炼的字段
UIQuenchConfirm	淬炼开始
UIQuenchBeforeTitle	持有的效果
UIQuenchAfterTitle	淬炼后效果
UIQuenchFinalTitle	淬炼成功
UIQuenchFinalBuff	附加效果
UIQuenchHoleCountTitle	可淬炼孔数
UIQuenchHoleCount1	{0}-{1}个
UIQuenchHoleCount2	{0}个
UIQuenchCosts	淬炼费用：
UIQuenchDialog1	淬炼所需费用为 {0} 文钱，您的金钱不足。
#修理界面	
UIRepairWearing	装备中
UIRepair0	总修理金额
UIRepair1	目前拥有金钱
UIRepair2	文钱
UIRepair3	修理
UIRepair4	修理全部
UIRepairDialog1	修理全部的装备需花费 {0} 文钱，是否要修理？
UIRepairDialog2	修理全部的装备需花费 {0} 文钱，您的金钱不足。
UIRepairDialog3	没有需要修理的装备。
#拆解界面	
UIDecompose0	总拆解金额
UIDecompose3	拆解
UIDecomposeDialog1	拆解全部的装备需花费 {0} 文钱，是否要拆解？
UIDecomposeDialog2	拆解全部的装备需花费 {0} 文钱，您的金钱不足。
UIDecomposeDialog3	没有选择要拆解的装备。
UIDecomposeResult	获得拆解道具
#重锻界面	
ReforgeType0	伤害至上
ReforgeType1	效果至上
ReforgeType2	平均成长
UIReforgeFinalTitle	重锻成功
UIReforgeNoReforge	此物品无法重新锻造
UIReforgeMaterialRequire	需求数量：
UIReforgeNotEnough	(数量不足)
UIReforgeNoMaterials	缺少强化所需要的材料！
UIReforgeStart	是否要以{0}的方式重新锻造？
UIReforgeChangeReforge	此武器已经重新锻造过了，确定要舍弃之前锻造的效果，来获得新的效果？
#熔炼界面	
UISmeltMaterialHintText	稀有度为{0}的{1}共{2}个
UISmeltConfirm	确认熔炼
UISmeltAutoFill	自动放入
UISmeltAutoReturn	全部取回
UISmeltNoMaterials	缺少熔炼所需要的材料！
#画面提示	
UIMouseHint	显示鼠标：{0}
#SkillTip	
SkillTipCondition	修练条件
SkillTipAffectedSkill	影响招式
SkillTipSkillAction	追加效果
SkillTipNeedWeapon	需装备
SkillTipNeedExp	经验
SkillTipNeedSkill	武学
SkillTipNeedTalent	感悟
SkillTipNotTalent	抵触
SkillTipNeedInventory	道具
SkillTipSwitchApCost	切换所需精力
SkillTipApCost	消耗精力
SkillTipManaCost	消耗内力
SkillTipSelector	攻击范围
SkillTipIsCounter	可反击
SkillTipAttack	基础伤害
SkillTipSingleRange	{0}
SkillTipMultiRange	{0}-{1}
SkillTipSelectorRange	有效距离
SkillTipBuffer	效果
SkillTipBuffer2	运行效果
SkillTipNeedInventoryValue	{0}{1}个
SkillTipNeedTypeTalentValue	{0}感悟{1}点
#成就界面	
UIAchievementRewardMsg	确定要领取奖励吗？
UIAchievementRewardTitle	奖励：
UIAchievementCanReward	(可领取奖励)
UIAchievementRewarded	(已完成)
UIAchievementProgressTitle	进度：
#战斗界面	
UIBattleGetInventory	获得道具
UIBattleGetSkill	可学习新技能
#战斗跳的讯息	
CaptureSuccess	驯服成功
CaptureFailure	驯服失败
CannotCapture	此目标无法驯服
PetRemoved	已达登场回合限制
#范围选择	
UnitSelector	单一
CircleSelector	区域
SegmentSelector	扇形
RectangleSelector	矩形
#阵营单位	
Affected0	队友
Affected1	我方
Affected2	敌方
#Mod模块	
CurrentMod	目前模块
ModUpload	上传模块
ModUploadCheck	是否要上传 {0} 模块？
ModUploading	模块 {0} 上传中…
ModUploadFinish	上传完成
ModUploadFailure	上传失败
ModUpdating	更新中…
ModApply	套用中
ModApplyCheck	是否要套用 {0} 模块？
IsRemoteMod	远程
#战斗	
CurrentTurn	回合{0}
BattleInfoApRecovery	每回合恢复精力
BattleInfoCountAttackSkill	反击技
Critical	暴击
Release	卸劲
Combo	连击
CounterAttack	反击
Trick	虚招
NoEquip	没有装备
MinorWeapon	(副手)
rate	率
value	值
KeepTurn	持续{0}回合
BeginUnitTalent	每回合累积{0} <color=#00ffff>{1} %</color>
AfterDamageTalent	每次受到攻击，累积{0} <color=#00ffff>{1} %</color>
CriticalEffect	爆击发动时，当次伤害增加 <color=#00ffff>{0} %</color>
ReleaseEffect	卸劲发动时，自身伤害减少 <color=#00ffff>{0} %</color>
ComboEffect	连击发动时，额外回复精力 <color=#00ffff>{0}</color> 点
CounterAttackEffect	反击发动时，以 <color=#00ffff>{0}</color> 回击敌人
TrickEffect	虚招发动时，对中招者随机附加一种负面状态 <color=#00ffff>{0}</color> 点
APRecovery	恢复精力
#异常状态TIP	
TipTurnLossHp	每回合失去气血<color=#00ffff>{0}</color>点
TipTurnLossMp	每回合失去内力<color=#00ffff>{0}</color>点
TipTurnLossAp	每回合精力恢复减少<color=#00ffff>{0}</color>点
TipAttackFall	攻击时伤害降低<color=#00ffff>{0}</color>%
TipIncreasedDamage	被攻击时伤害提高<color=#00ffff>{0}</color>%
TipAttackLossHp	攻击时会造成自身<color=#00ffff>{0}</color>点气血损失
TipBan	{0}无法发动、累计数值
TipZero	{0}数值归<color=#00ffff>0</color>
TipCramped	每一点精力所移动的距离减为{0}%
TipSealed	最大精力减少为<color=#00ffff>{0}</color>点
TipFrozen	{0}减少<color=#00ffff>{1}</color>点
TipDazed	每回合开始<color=#00ffff> {0} %</color>无法行动
#按键TIP	
TipWaiting	等待<br>消耗 {0} 点精力
TipChangeSkill	更换快捷
TipOpenInventory	开启背包<br>更换武器消耗 {0} 点精力<br>使用道具消耗 {1} 点精力
TipRest	结束行动
TipFinish	结束战斗
TipGameMenu	游戏选单
#战斗讯息	
MsgBeginBattle	战斗 {0} 开始
MsgEndBattle	战斗 {0} 结束
MsgBeginTurn	开始第 {0} 回合
MsgEndTurn	结束第 {0} 回合
MsgBeginUnit	{0} 开始行动
MsgEndUnit	{0} 结束行动
MsgCounterAttackNotFound	{0} 无反击技能
MsgCounterAttack	{0} 使用 {1} 反击
MsgCounterAttackFail	反击失败
MsgPleaseSelectAvaliableTarget	请选择有效目标
MsgUnavaliableBlinkPosition	无法闪现至此目标附近
MsgTargetTooFar	距离 {0} 太远
MsgUseSkill	{0} 使用了 {1} 技能
MsgUnitDead	{0} 死亡
MsgReduceDueTo	{0} 因 {1} 减少 {2} {3}
MsgAddDueTo	{0} 因 {1} 增加 {2} {3}
MsgAddProp	{0} {1} 增加 <color=#FFFF00>{2}</color>
MsgSubProp	{0} {1} 减少 <color=#FFFF00>{2}</color>
MsgUnitDeadDueToInjured	{0} 因内伤死亡
MsgRaiseComboAttack	{0} 发动连击，+{1} AP
MsgUnitDodge	{0} 闪过了此攻击
MsgResetRelease	{0} 卸劲归零
MsgReceiveDamage	{0} 对 {1} 造成了 <color=#FFFF00>{2}</color> 点伤害
MsgReceiveCriticalDamage	{0} 对 {1} 造成了 <color=#FFFF00>{2}</color> 点爆击伤害
MsgReceiveHeal	{0} 对 {1} 造成了 <color=#FFFF00>{2}</color> 点治疗
MsgResetCounterAttack	{0} 反击归零
MsgGainDebuffDueToTrick	{0} 因为虚招获得随机负面状态值
MsgGainProperty	{0} 获得状态值 {1} : {2}
MsgCurrentProperty	{0} 目前{1}：{2}
MsgAPNotEnough	精力不足
MsgMPNotEnough	内力不足
MsgLaunch	{0}
MsgHaveNot	{0} 无 {1}
#结局00	
Final00_00	梦幻泡影
Final00_01	伴随着播报员事不关己的嗓音，
Final00_02	冰冷的大屏幕像是重大新闻间的调剂消遣般，
Final00_03	临时插播了你的失踪报导，
Final00_04	没有人知道你消逝在了某个遥远的世界。
Final00_05	即便你的家人朋友多方奔走，
Final00_06	苦寻多年，却依旧没有你的消息。
Final00_07	日月飞梭，物换星移，
Final00_08	最终无可避免地，人们慢慢淡忘了你的存在，
Final00_09	所留下的，或许只有在提起你的名字时，
Final00_10	所发出的一声轻叹｜
#结局01	
Final01_00	似箭归心
Final01_01	一如每个美好故事的结尾，善有善果，恶有恶报，
Final01_02	即便是按照惯例，在最后自暗处向你伸出的恶意，
Final01_03	也无法阻挡你回家的决心。
Final01_04	这次的旅程，对你而言虽是一首意外的插曲，
Final01_05	却会在往后的将来时刻警醒着你，
Final01_06	怨天尤人，放弃眼前人生的下场，
Final01_07	最终将会是如何。
Final01_08	你摇了摇头，抛开了沉重的思绪，
Final01_09	对着在这趟旅程中与你一同奋战的朋友们，
Final01_10	露出微笑，挥手道别。
Final01_11	锦城虽云乐，不如早还家。
Final01_12	怀着一丝兴奋却又忐忑不安的心情，
Final01_13	你再度踏入了那既熟悉又陌生的圣堂之门。
Final01_14	这一次在前方等待着你的，
Final01_15	会是温暖的家，
Final01_16	抑或会是另一场新的冒险？
#结局 02	
Final02_00	白首之心
Final02_01	你一掌拍醒了眼前那个龟缩于虚幻，
Final02_02	不断逃避现实的老人。
Final02_03	他所追求的虚幻美好无法将他从悲惨的现实中解脱，
Final02_04	那是你拒绝屈从的未来，
Final02_05	也是一面你不能放手的镜子。
Final02_06	人生存在着美好，
Final02_07	但它永远都不会在轻言放弃的人们面前出现。
Final02_08	你要做的事只有一个，
Final02_09	就是将眼前的老人带回去，
Final02_10	重拾彼此为了美好人生而奋斗的决心。
Final02_11	回到家后，无论现实有多么苦涩，
Final02_12	你们都将勇敢向前，书写自己的人生！
Final02_13	谁道人生无再少？
Final02_14	门前流水尚能西！休将白发唱黄鸡。
#结局 03	
Final03_00	见性明心
Final03_01	天书齐心，所向披靡，
Final03_02	不过转瞬之间，蜀中高手尽皆败于你二人手下。
Final03_03	你冷眼扫过地上那些曾与你站在同一阵线的友人，
Final03_04	一具具七零八落的尸身，
Final03_05	无不在向你诉说着过往的愚昧。
Final03_06	是「你」告诉了自己，
Final03_07	不该再被愚蠢的仁义道德所限制，
Final03_08	让到手的力量从眼前溜走。
Final03_09	回首望向那陌生却又熟悉的「你」，彼此相视一笑，
Final03_10	今后，你俩将携手同行，
Final03_11	创造只属于「你」的理想未来。
Final03_12	在那一霎那，你更加确信自己选择了正确的道路。
Final03_13	正是：钱塘江上潮信来，今日方知我是我！
#结局 04	
Final04_00	狼子野心
Final04_01	有道是：九言劝醒迷途仕，一语惊醒梦中人。
Final04_02	那个倒在血泊中的「你」确实说对了一件事，
Final04_03	力量不该被白白浪费。
Final04_04	正因如此，它最应该被用以夺取更加强大的力量。
Final04_05	所谓的未来既然如此丑陋，何不让它就此被遗忘？
Final04_06	瞧着这片折枪断戟，尸山血海，
Final04_07	这就是你改造世界的力量。
Final04_08	你会用这份力量，将虚幻化为崭新的未来，
Final04_09	没有任何人能够阻挡你的欲望和企图。
Final04_10	那个潜藏在你心中的理想国度，
Final04_11	已是近在咫尺，唾手可得！
#结局 05	
Final05_00	苍山之麓
Final05_01	段思平与南诏诸族所组成的义军，
Final05_02	一路势如破竹，攻破南诏王都洱城，
Final05_03	杨天义仓皇出逃，不知所终。
Final05_04	而后段思平登基为帝，创立大理国，
Final05_05	致力改善南诏诸族的生活，
Final05_06	缔造了往后数百年立足滇南的强盛大国。
Final05_07	为感念金鼎禅师传功之恩，
Final05_08	段思平于城中修建天龙寺，命段家子孙世代供奉。
Final05_09	听闻何白芍死去的噩耗，
Final05_10	何玉蝶体认到过去所犯下的错误，
Final05_11	决定将领导箐寨的权力和重任下放给多名箐寨族人。
Final05_12	何紫菀在作为继任族长之余，
Final05_13	终于也有了追求自由的权力。
Final05_14	在她领导期间，箐寨作为支持大理国的中流砥柱，
Final05_15	持续繁荣昌盛，与大理国一同迈向了辉煌的未来。
Final05_16	二人自苍山远眺这个得来不易的成果，
Final05_17	遥想那位曾在旅程中扮演了重要角色的天外来客，
Final05_18	猜想着他如今会在何处？
Final05_19	今后又是否会有一同班荆道旧，剪烛西窗的一天？
#结局 06	
Final06_00	白马闲情
Final06_01	纷乱的世道依旧纷乱，白马居的人们却恍若无觉，
Final06_02	嘻笑劳作、日出日落。
Final06_03	漆笑儿乍然脱离师门，也曾惶惶无措，
Final06_04	白日里看似倔强，夜里暗自神伤。
Final06_05	所幸李叹对她悉心呵护，带着漆笑儿云游四海。
Final06_06	两人也曾偷回点苍师门留下书信，
Final06_07	跪请师父勿念勿挂。
Final06_08	最后回到白马居定居成婚，相伴一生。
#结局 07	
Final07_00	雪山神鹰
Final07_01	木府虽经历过一场政变浩劫，牺牲无数，
Final07_02	但却因此变得更加团结，不再有派系之争。
Final07_03	由木初所领导的木府，
Final07_04	为大研镇带来了一段安稳和平的日子。
Final07_05	阿得阿克则不忘理想，在将聚落安顿好之后，
Final07_06	便乘上船，渡过大泽，向东方游历而去。
Final07_07	数年后，大研镇便有了这样的传闻：
Final07_08	在遥远的东方武林，出现一名与鹰为伴的外地旅者，
Final07_09	以一手精湛箭术，剿灭贼窟，平定祸乱。
Final07_10	「雪山神鹰」之名，很快地传遍了整个武林。
Final07_11	几度寒暑，历经风霜的阿得阿克终于远行归来，
Final07_12	受到众镇民的热烈拥戴。
Final07_13	他将驯鹰的技艺传授予镇民与卫兵，
Final07_14	使大研镇成为了儒学与鹰猎传统交融的美丽城镇。
Final07_15	日后，每次来到木奎的坟前，阿得阿克总不禁遥想，
Final07_16	那名曾经一同并肩作战的天外来客，
Final07_17	现在又到了什么地方？
Final07_18	也许今后再无相见之日，但共同经历过的那段旅程，
Final07_19	阿得阿克却是未曾遗忘。
#结局 08	
Final08_00	曲终奏雅
Final08_01	江湖起落，俏梦阁却总能在各方势力间巧妙沉浮，
Final08_02	樊香蝶带着姐妹渡过一次又一次的难关与各方觊觎，
Final08_03	并在苏清瑞的财力支持下，
Final08_04	进一步将情报范围扩及整个西川。
Final08_05	苏清瑞在经过景泰然事件后，
Final08_06	痛定思痛重振苏府，
Final08_07	并广纳贤德才士悉心经营势力，
Final08_08	依靠俏梦阁的情报网络，
Final08_09	调动人马支持西川各方正道，
Final08_10	终于成为江湖上一经提起，
Final08_11	便人人竖起拇指大声叫好的小孟尝、苏大侠。
#结局 09	
Final09_00	动如参商
Final09_01	赋闲书院的惨案发生后，院中的藏书毁于一旦，
Final09_02	无数珍贵的武学秘籍就此失落。
Final09_03	但没了锦衣卫的暗地挑拨，
Final09_04	江湖上的腥风血雨总算是少了那么一点。
Final09_05	数月之后，一名剑法精奇的神秘女剑客横空出世，
Final09_06	这名女剑客踽踽独行，一路向北，
Final09_07	一手妙到巅毫的剑法，天下无人能敌。
Final09_08	每当被人问起她旅途的目的，
Final09_09	她只是笑而不语。
Final09_10	但就在她声名达到巅峰之际，
Final09_11	她却消失在长城之外，从此不现踪迹。
Final09_12	数十年后，江湖仍流传着那名如流星般出世，
Final09_13	亦如流星般消失的女剑客的故事。
Final09_14	瞭望着母亲出生的广阔草原，
Final09_15	颜玉书终于了却心中的一桩心愿。
Final09_16	接下来，她想要看看这个世界，
Final09_17	也许在某个地方，会有另一扇圣堂之门，
Final09_18	能够通往他所在的那个地方。
#结局 10	
Final10_00	月落星沉
Final10_01	争夺天书的风波结束后，
Final10_02	颜玉书与东方迟悄然离开了赋闲书院。
Final10_03	皇帝朱元璜虽曾派人搜寻，但却总是一无所获。
Final10_04	数月之后，一名剑法精奇的神秘女剑客横空出世，
Final10_05	这名女剑客踽踽独行，一路向北，
Final10_06	一手妙到巅毫的剑法，天下无人能敌。
Final10_07	每当被人问起她旅途的目的，
Final10_08	她只是笑而不语。
Final10_09	但就在她声名达到巅峰之际，
Final10_10	她却消失在长城之外，从此不现踪迹。
Final10_11	数十年后，江湖仍流传着那名如流星般出世，
Final10_12	亦如流星般消失的女剑客的故事。
Final10_13	瞭望着母亲出生的广阔草原，
Final10_14	颜玉书终于了却心中的一桩心愿。
Final10_15	如今，她的脑海中只剩下一个念头。
Final10_16	来世，是否能有再见的一天？
#结局 11	
Final11_00	倚鞍思骏
Final11_01	对于禾泓渊的死，禾郁青极为自责，
Final11_02	也因此她收起了以往的蛮横任性，
Final11_03	带领着禾家马帮，
Final11_04	一次又一次地对抗穷山恶水与山贼的侵袭。
Final11_05	虽然禾家马帮不再一枝独秀，
Final11_06	但禾郁青凭借着精湛的刀法与坚韧的性格，
Final11_07	仍然成为天南武林中最令人崇敬的马锅头。
Final11_08	禾郁青始终将守护禾家马帮视为自身的责任，
Final11_09	然而老一辈的帮众时常这样说着，
Final11_10	「阿郁不再是以前的阿郁了。」
Final11_11	年轻的帮众始终不知道这是甚么意思，
Final11_12	或许连禾郁青自己也不知道。
Final11_13	她深遂眼眸中闪烁着落寞，
Final11_14	是因为肩上的责任过于沉重？对父亲的死感到愧疚？
Final11_15	又或者，在她内心深处，其实还藏着其它的想望？
#结局 12	
Final12_00	逐日之影
Final12_01	黄裳竭尽全力，
Final12_02	仍旧未能拦下那个纵放祸首的天外来客，
Final12_03	他只能眼睁睁的看着他进入圣堂之门，
Final12_04	消失于虚空之中。
Final12_05	改过自新？行善赎罪？
Final12_06	在那个自负侠义的天外来客吐出那些伪善之词，
Final12_07	践踏他逝去妻儿尊严的同时，
Final12_08	便也成了他黄裳的仇人之一。
Final12_09	日复一日，年复一年，
Final12_10	不论河洛一族如何苦心开导，他也不曾有丝毫软化，
Final12_11	他杀光了当年不赦楼的余孽，
Final12_12	启程追寻早已转移显现地点的圣堂。
Final12_13	不论那名天外来客逃到何处，
Final12_14	为了他逝去妻儿的冤苦，
Final12_15	也为了他难以平息的复仇之火，
Final12_16	只要他还存着一口气，
Final12_17	必将如影随形，杀之后快。
#结局 13	
Final13_00	济世药王
Final13_01	程雁华与杜晋鹏恩断义绝，
Final13_02	带着女儿隐居藏花草棚，
Final13_03	帮助陈之济医治贫苦百姓。
Final13_04	不过程雁华心如止水，不愿再生波澜，
Final13_05	因此对外之事遂由陈之济一力担下，
Final13_06	久之，程娘子名号逐渐淡出世人目光。
Final13_07	绯绯聪明好学，跟着陈之济学习医毒之术，
Final13_08	领悟较其母更胜十分，
Final13_09	并在陈之济过世后，继其衣钵，
Final13_10	成为新一代药王传人。
Final13_11	石鸿图经此一役，暂时匿迹江湖，
Final13_12	等待适当时机，再次出手。
#结局 14	
Final14_00	辣手毒心
Final14_01	在冯秋香的暗中运作下，程雁华最终横死杜府。
Final14_02	杜晋鹏悲恨难平，却又不敢作声，
Final14_03	将怒火一股脑儿发泄在藏花草棚。
Final14_04	石鸿图始终未能寻药王神篇，
Final14_05	性情益发暴虐，毒王之名不胫而走。
Final14_06	杜玉绯却于母亲过世后继承药王神篇，
Final14_07	忍辱两年，最终使计毒杀了杜家满门。
Final14_08	十年之后，
Final14_09	原藏花草棚之地多出了一亩小小的花田，
Final14_10	药王之名再度崛起。
#结局 15	
Final15_00	再造天伦
Final15_01	回顾过去，司徒荆一生坎坷，
Final15_02	幼年入宫受尽欺压，
Final15_03	被赶出宫后，又因阉人之身受尽轻视。
Final15_04	刻苦修习毒功，终日心念报仇，愤恨无一日安宁。
Final15_05	在经历酒庄的当头棒喝后，
Final15_06	痛定思痛，于酒庄留下小容秀后离去。
Final15_07	一世富贵陈老太爷见容秀聪明善良，
Final15_08	在明白孙子陈志淇志在云游，无意继承酒庄后，
Final15_09	将一身酿酒技术悉数传与容秀，
Final15_10	并在寿终之日立下酒庄传贤不传族的规矩，
Final15_11	打破一世富贵由陈家子弟把持的陋规，
Final15_12	将酒庄传给晏容秀继承。
Final15_13	容秀成年后，几经寻访，
Final15_14	终于找到隐居的司徒荆，
Final15_15	将其接至酒庄近郊定居，
Final15_16	日日请安，孝奉身侧，颐养天年。
#结局 16	
Final16_00	万劫不复
Final16_01	司徒荆带着晏容秀浪迹天涯，
Final16_02	并将一身邪派武功尽数传与容秀，
Final16_03	当年曾经参与击杀晏葆川的杀手被一一找出，
Final16_04	并以尸蛇毒血功凌迟虐杀。
Final16_05	晏容秀耳濡目染，成年之后成为邪道高手，
Final16_06	烧杀掳掠，江湖中人人闻之色变。
Final16_07	回顾过去，司徒荆一生坎坷，
Final16_08	幼年入宫受尽欺压，被赶出宫后又因阉人之身受尽凌辱，
Final16_09	习得邪派功法后，终日心念报仇，
Final16_10	愤恨无一日安宁，
Final16_11	因年轻之时心急练功，
Final16_12	而巧取旁门左道方法强练尸蛇毒血功，
Final16_13	最终遭到功法反噬，死时内脏溃烂，
Final16_14	呻吟七七四十九天后，
Final16_15	于西川一处僻巷民宅中断气。
#结局 17	
Final17_00	大道丹心
Final17_01	在战胤飞引起的动荡之下，
Final17_02	王喆眼见义兄李彦仙、义姐白露霜
Final17_03	为了阻饶不赦楼而双双牺牲。
Final17_04	哀痛之余，他下定决心继承义兄遗志，
Final17_05	一生抵御外患、保家卫国。
Final17_06	重登擎天以后，王喆接下寨主之位，
Final17_07	率领擎天寨众力抗狼蛮。
Final17_08	在领军跋涉途中，
Final17_09	王喆又几度遇上了在卧龙村结识的道人纯阳子，
Final17_10	每次相遇，纯阳子必从旁点拨，
Final17_11	引导王喆领悟「太清罡气」中的道学深意，
Final17_12	王喆在武学与道学资质皆高，
Final17_13	虽心系国事、投身军旅，在年近知命之时，
Final17_14	仍悟得「太清罡气」最深一层绝学，
Final17_15	数年后创立全真教派，开创绝世武学，
Final17_16	被世人尊为「重阳真人」。
Final17_17	然而每次听闻外敌进犯，
Final17_18	王喆总会想起义兄死前的一番话，
Final17_19	想起义兄保卫家国，置个人死生于度外的胸襟气度。
#结局 18	
Final18_00	停云落月
Final18_01	在蜀中波澜壮阔的历险结束后，
Final18_02	张君宝先后挥别了两名友人，
Final18_03	再次踏上了云游天下的旅途。
Final18_04	当年信誓旦旦说着会再相见的三人从此天各一方。
Final18_05	三十年前，蜀中大疫，
Final18_06	张三丰一路由中原赶至西川，
Final18_07	恰恰来得及见上老友最后一面。
Final18_08	如今他也已年近百岁，虽说一身精纯内功已臻化境，
Final18_09	但是近年来也渐渐有了力不从心之感。
Final18_10	这一夜，张三丰独自坐在房中，忽然心有所感，
Final18_11	向着天外来客当年离开的圣堂远眺
Final18_12	「你这家伙，再不来｜老朋友可不等你了啊。」
#结局 19	
Final19_00	幽冥暗鬼
Final19_01	自从那日将那人打落那无名深谷中后，
Final19_02	百损道姑的心里就有根刺｜
Final19_03	她没听见那人落地的声音。
Final19_04	好几次夜里，她彷佛又回到了那万丈深谷边，
Final19_05	看着那张爽朗的令人讨厌的脸消失在视线范围。
Final19_06	但不论她多么地专注，多么地仔细，
Final19_07	她还是没能听见那梦寐以求的，美妙的坠地声。
Final19_08	唯有枯谷中呼啸的风声，哑哑地嘲笑着她。
Final19_09	为了拔掉心里的那根刺，数年来她拼命修练武功，
Final19_10	将师门的武学提高到了前人无法想象的境界。
Final19_11	新收的两个徒弟一个劲地逢迎拍马，
Final19_12	但她自己知道，那人是真正的武学天才，
Final19_13	她不会有胜过他的一天。
Final19_14	最近耳边的风声越来越清晰了，那分明是他的声音。
Final19_15	「我会来找你的。」
#结局 20	
Final20_00	鹊桥星辉
Final20_01	那日她在圣堂奋不顾身的一跃，
Final20_02	永远的改变了你的人生。
Final20_03	终于也轮到了你，
Final20_04	体会平淡的生活被天外来客搅得一团乱的滋味。
Final20_05	一个没有身分的异界女子，在这里日日都是冒险。
Final20_06	一个重返现实的失踪人口，再也过不上平凡的人生。
Final20_07	尽管如此，她也是你那段异世界历险的唯一证明，
Final20_08	经过那些仗剑江湖的奇异日子，
Final20_09	武侠世界早已成了你另一个家乡。
Final20_10	每当你回想到那些刻骨铭心的时刻，
Final20_11	亦或是惦念起着曾经同生共死的某人。
Final20_12	以为电话与计算机是某种妖法邪术的她，
Final20_13	成了你可以任意倾诉的唯一对象。
Final20_14	每天一早，当你又听到她的惊呼声，
Final20_15	伴随着某种电器用品失控的噪音传来，
Final20_16	你就知道，天外来客的故事还没有结束。
#结局 21	
Final21_00	天生我材
Final21_01	你带着他走出拱石村，
Final21_02	藉由一路的冒险，展现了江湖充满情义的一面。
Final21_03	看着你充满活力的笑容，
Final21_04	骆元玉暗自下定决心，
Final21_05	要成为一个和你一样的人。
Final21_06	善于和人打交道的他，
Final21_07	很快的聚集了一群看似无用的乞丐，
Final21_08	以乞丐寮为据点，经营起自己的事业｜
#结局 22	
Final22_00	兔死狗烹
Final22_01	你带着他走出拱石村，藉由一路的冒险，
Final22_02	他也逐渐成长、强大。
Final22_03	可随你征战天下多年，原本以为功成名就的他，
Final22_04	最后竟遭到不愿分权的你，翻脸无情的追杀。
Final22_05	心狠手辣、权变时宜，成为他人生的座右铭。
Final22_06	善于和人打交道的他，很快的东山再起，
Final22_07	聚集了一群看似无用的乞丐，
Final22_08	以乞丐寮为据点，经营起自己的事业｜
#结局 23	
Final23_00	温语凝眸
Final23_01	原本我会一辈子待在太华门，
Final23_02	不明白外面的世界，
Final23_03	不知道祖父母的故事，
Final23_04	不认识｜你，
Final23_05	不过好在我们相遇了。
Final23_06	大哥，谢谢你，我会好好的。
Final23_07	你也是｜
#结局 24	
Final24_00	江山美人
Final24_01	红颜祸水？倾国倾城？
Final24_02	面对部下对你的进言，
Final24_03	你一笑置之，全无顾忌地，
Final24_04	将身旁巧笑倩兮的美人们搂入怀中。
Final24_05	彻底掌控天下的你回想起了那一刻，
Final24_06	当时选择站在你身边的她们，
Final24_07	渴求着长远的归属和依靠，
Final24_08	那是另一个坚守正道，
Final24_09	一心只想着回家的自己所无法给予的东西。
Final24_10	所以你做了决定，你会满足她们，
Final24_11	给她们一个不再孤独的未来。
Final24_12	但到了今日，
Final24_13	她们在你心中的真正地位又是如何呢？
Final24_14	扪心自问，你总算是明白了，
Final24_15	她们终究只是你尊贵身分的消遣，
Final24_16	陪伴、宠幸，
Final24_17	那都是作为主宰的你所赐予的恩典，
Final24_18	你的伴侣从来不是甚么美人，
Final24_19	而是这如画江山，无上权力。
#自宫	
cutyourself	修练残花宝鉴
cutyourself02	修练这门武功必须自宫，请问您是否要继续修练？