Below is the **Glossary for Consistent Translations**: Use the translation if an exact match with original text
is found.

### Glossary Entries:
- #### Character Names
  - 阿得阿科: Ade Ake
  - 李坦: Li Tan
  - 王哲: Wang Zhe
  - 何钰清: He Yuqing
  - 端思平: Duan Siping
  - 段思朗: Duan Silang
  - 何子旺: He Ziwang
  - 黄尚: Huang Shang
  - 樊祥跌: Fan Xiangdie
  - 白孙: Bai Sun
  - 罗远渔: Luo Yuanyu
  - 张君宝: Zhang Junbao
  - 阎玉书: Yan Yushu
  - 程延华: Cheng Yanhua
  - 司徒镜: Situ Jing
  - 施鸿涂: Zhuan Sunning
  - 施鸿涂: Shi Hongtu
  - 徐暇客: Xu Xiake
  - 徐花: Xu Hua
  - 迦罗: Jia Luo
  - 以娟: Yi Juan
  - 孔金: Kong Jin
  - 汪治枣: Wang Zhizao
  - 阿巧: A Qiao
  - 南贤: Southern Sage
  - 南闲: Southern Leisure
  - 东豪: Eastern Noble   
  - 北丑: Northern Ugly
  - 西庖: Western Kitchen

- #### Locations and Places
  - 村长屋: Village Chief's House
  - 测试区域: Taoshi Guildmaster's Manor
  - 木氏土司: Mù Clan Headquarters
  - 漱玉矶: Gleaming Jade Beach
  - 拱石村: Arched Stone Village
  - 邵氏玉坊: Shao Family Jade Courtyard
  - 鹰猎人聚落: Eagle Hunter Village
  - 擎天寨: Heaven's Pillar Fort
  - 大研镇: Dayan Town
  - 俏梦阁: Charming Dream Hall
  - 善人府: Goodwill Mansion
  - 丈人村: Elder's Village
  - 青城派: Qingcheng Sect
  - 赋闲书院: Leisurely Scholars Academy
  - 浣花溪亭: Wan Hua Creek Pavilion
  - 天龙寺: Tianlong Temple
  - 一世富贵: Lifetime Prosperity
  - 一世富贵酒庄: Lifetime Prosperity Winery
  - 噶玛寺: Karma Monastery
  - 迷魂水寨: Enchanted Spirit Water Fortress
  - 石家盐帮: Shi Family Salt Gang
  - 大云庵: Big Cloud Monastery
  - 藏花草棚: Flower and Herb Stall
  - 千佛崖: Thousand Buddhas Cliff
  - 西川都司: Western River Command Post
  - 先民遗迹之所: Ancient Heritage Ruins
  - 风云渡: Windcloud Crossing
  - 卧龙村: Dragon's Rest Village
  - 武侯祠: Temple of the Military Sage
  - 布政使司衙门: Regional Governor’s Office
  - 遂心岛: Heart’s Desire Island
  - 快意村: Joyful Village
  - 无底深渊: Bottomless Abyss
  - 望陇村: Viewpoint Village
  - 下河村: Riverside Village
  - 锦河津: Brocade River Crossing
  - 白马居: White Horse Residence
  - 美馔楼: Delicacies Pavilion
  - 圣堂: Holy Sanctuary

- #### Special Terms
  - 武侠: Wuxia
  - 气: Qi
  - 河图: Hetu
  - 洛书: Luoshu
  - 天书: Heavenly Scriptures
  - 武林: Wulin
  - 江湖: Jianghu
  - 河洛: Heluo
  - 刀: Blade
  - 刀法: Blade Arts
  - 短兵: Short Weapons
  - 暗器: Hidden Weapon
  - 错骨: Joint Manipulation
  - 缠拿: Grapple
  - 轻功: Qinggong
  - 内功: Neigong
  - 枪棍: Spear
  - 资质: Aptitude
  - 剑法: Sword Arts
  - 搏击: Hand Combat
  - 烈: Fierce
  - 绝: Ultimate
  - 封: Seal
  - 钱: Money
  - 迷惑: Confused
  - 散功: Disperse Qi
  - 醉意: Drunk
  - 内伤: Internal Injury
  - 蟒蛇: Python
  - 黄连: Coptis root
  - 剧情: Plot  
  - 玄铁: Dark Steel
  - 淘石: Taoshi
  - 南诏: Nanzhao
  - 野球拳: Baseball Fist
  - 马帮: Horse Gang
  - 槟榔: Betel nut
  - 龙珠: Dragon ball
  - 炼狱: Purgatory

  - 气血: Lifeforce

  - 简单: Easy
  - 困难: Normal
  - 炼狱: Hard
